0 0 34 35 0 34 35 0 36 37 0 0 0 0 0 0 0 0 0 0 0 0 0 34 36 0 0 0 36 37 34 35 0 0 35 37 0 0 0
0 36 37 34 0 36 37 35 34 35 37 0 0 0 0 0 0 0 0 0 0 0 35 37 34 36 0 34 35 36 37 35 34 0 36 34 37 0 0
0 35 34 36 0 35 34 36 37 36 34 0 0 0 0 0 0 0 0 0 0 0 36 35 37 35 0 37 34 35 34 36 37 0 35 37 34 0 0
0 37 36 0 0 37 35 0 35 34 36 0 0 0 0 0 0 0 0 0 0 0 34 36 35 0 0 36 37 34 36 35 0 0 34 36 35 0 0
35 36 0 0 0 0 0 0 37 35 34 36 0 0 0 0 0 0 0 0 0 37 35 34 0 0 0 35 37 0 0 0 0 34 36 37 34 35 0
34 37 35 0 0 0 0 36 34 37 35 36 0 0 0 0 0 0 0 0 34 36 37 35 0 0 0 34 36 0 0 0 36 37 35 34 37 36 0
36 35 37 34 0 0 0 35 37 34 36 0 0 0 0 0 0 0 0 0 35 34 36 37 0 0 0 37 35 0 0 0 35 34 36 37 35 34 0
37 34 36 0 0 0 0 0 0 0 0 0 0 0 0 0 0 0 0 0 0 0 0 0 0 0 0 0 0 0 0 0 0 0 0 0 0 0 0
34 35 0 0 0 0 36 37 34 0 0 0 0 0 0 0 0 0 0 0 0 0 0 0 0 0 0 34 35 36 0 0 0 35 37 34 0 0 0
37 36 34 0 0 35 37 35 36 34 0 0 0 0 0 0 0 0 0 0 0 0 0 0 0 0 37 36 34 35 37 0 0 36 34 37 35 0 0
35 34 37 0 0 36 34 37 35 0 1 1 2 2 2 2 2 2 2 2 2 2 2 2 2 2 2 2 1 0 35 37 34 36 0 34 37 36 35 0
36 37 0 0 0 0 35 36 0 0 3 4 4 4 4 4 4 4 4 4 4 4 4 4 4 4 4 4 3 0 0 36 35 0 0 37 34 35 36 0
34 35 0 0 0 0 0 0 0 0 3 0 0 34 35 36 36 37 0 0 0 0 0 0 47 0 0 0 3 0 0 0 0 0 0 35 36 37 34 0
37 36 0 0 0 0 0 0 0 0 3 0 47 34 35 36 37 37 0 47 0 0 0 0 0 0 0 0 3 0 0 0 0 0 0 34 37 35 36 0
35 34 37 0 0 0 0 0 0 0 3 36 36 35 34 0 36 37 37 0 0 47 0 34 35 36 0 0 3 0 0 0 0 0 36 35 34 37 36 0
36 37 35 34 0 0 0 0 0 0 3 0 5 6 7 8 0 0 47 0 0 0 36 36 37 35 0 0 3 0 0 0 0 34 37 36 35 34 37 0
34 36 37 35 0 0 0 0 0 0 3 0 11 12 13 14 0 0 0 0 47 0 0 36 37 37 36 0 3 0 0 0 0 35 34 37 36 35 34 0
37 35 34 36 0 0 0 0 0 0 3 0 17 18 19 20 0 34 35 36 37 0 0 0 0 0 0 0 3 0 0 0 0 36 37 34 35 36 37 0
35 37 36 34 0 0 0 0 0 0 3 0 23 24 25 26 0 35 36 37 37 36 0 47 0 34 36 0 3 0 0 0 0 34 35 36 37 34 35 0
36 34 35 37 0 0 0 0 0 0 3 1 2 2 2 2 2 2 2 0 2 2 2 2 2 2 2 2 3 0 0 0 0 37 36 35 34 37 36 0
37 35 36 34 0 0 0 0 0 0 3 4 4 4 4 4 4 4 4 0 4 4 4 4 4 4 4 4 3 0 0 0 0 35 37 34 36 35 37 0
34 36 37 35 0 0 0 0 0 0 0 0 0 0 0 0 0 0 0 0 0 0 0 0 0 0 0 0 0 0 0 0 0 36 34 37 35 36 34 0
35 37 34 36 0 0 0 0 0 0 0 0 0 0 0 0 0 0 0 0 0 0 0 0 0 0 0 0 0 0 0 0 0 34 35 36 37 34 35 0
36 34 35 37 34 0 0 0 0 0 0 0 0 0 0 0 0 0 0 0 0 0 0 0 0 0 0 0 0 0 0 35 37 36 34 35 37 36 34 0
37 35 36 34 37 35 0 0 0 0 0 0 0 0 0 0 0 0 0 0 0 0 0 0 0 0 0 0 0 0 36 34 35 37 36 34 35 37 35 0
34 36 37 35 36 34 37 0 0 0 0 0 0 0 0 0 0 0 0 0 0 0 0 0 0 0 0 0 0 34 37 35 36 34 37 35 36 34 37 0
35 37 34 36 35 37 34 35 0 0 0 0 0 0 0 0 0 0 0 0 0 0 0 0 0 0 0 0 36 35 34 37 35 36 34 37 35 36 34 0
36 34 35 37 36 34 35 36 37 0 0 0 0 0 0 0 0 0 0 0 0 0 0 0 0 0 0 34 35 36 37 34 36 35 37 34 36 37 35 0
37 35 36 34 37 35 36 37 34 35 0 0 0 0 0 0 0 0 0 0 0 0 0 0 0 0 36 37 34 35 36 37 35 34 36 37 34 35 36 0
34 36 37 35 34 36 37 34 35 36 37 0 0 0 0 0 0 0 0 0 0 0 0 0 0 35 37 34 36 35 34 37 36 35 37 34 35 36 37 0
35 37 34 36 35 37 34 35 36 37 34 35 0 0 0 0 0 0 0 0 0 0 0 0 36 34 35 37 35 36 37 34 35 36 34 37 36 35 34 0
