1 1 2 2 2 2 2 2 2 2 2 2 2 2 2 2 2 2 1
3 4 4 4 4 4 4 4 4 4 4 4 4 4 4 4 4 4 3
3 0 0 34 0 0 0 0 37 0 0 34 0 0 47 36 0 0 3
3 0 0 37 35 0 0 47 0 0 0 0 0 0 0 0 0 0 3
3 36 0 0 0 0 36 0 0 37 0 0 34 35 0 0 34 0 3
3 0 5 6 7 8 0 0 0 0 0 0 0 36 0 0 0 35 3
3 0 11 12 13 14 0 0 35 0 37 0 0 47 0 36 0 0 3
3 0 17 18 19 20 35 0 34 0 0 35 0 0 0 0 0 0 3
3 46 23 24 25 26 0 35 0 0 0 0 36 0 0 34 0 0 3
3 1 2 2 2 2 2 2 2 2 2 2 2 2 2 2 2 2 3
3 4 4 4 4 4 4 4 4 4 4 4 4 4 4 4 4 4 3