0 0 37 38 0 37 38 0 39 40 0 0 0 0 0 0 0 0 0 0 0 0 0 37 39 0 0 0 39 40 37 38 0 0 38 40 0 0 0
0 39 40 37 0 39 40 38 37 38 40 0 0 0 0 0 0 0 0 0 0 0 38 40 37 39 0 37 38 39 40 38 37 0 39 37 40 0 0
0 38 37 39 0 38 37 39 40 39 37 0 0 0 0 0 0 0 0 0 0 0 39 38 40 38 0 40 37 38 37 39 40 0 38 40 37 0 0
0 40 39 0 0 40 38 0 38 37 39 0 0 0 0 0 0 0 0 0 0 0 37 39 38 0 0 39 40 37 39 38 0 0 37 39 38 0 0
38 39 0 0 0 0 0 0 40 38 37 39 0 0 0 0 0 0 0 0 0 40 38 37 0 0 0 38 40 0 0 0 0 37 39 40 37 38 0
37 40 38 0 0 0 0 39 37 40 38 39 0 0 0 0 0 0 0 0 37 39 40 38 0 0 0 37 39 0 0 0 39 40 38 37 40 39 0
39 38 40 37 0 0 0 38 40 37 39 0 0 0 0 0 0 0 0 0 38 37 39 40 0 0 0 40 38 0 0 0 38 37 39 40 38 37 0
40 37 39 0 0 0 0 0 0 0 0 0 0 0 0 0 0 0 0 0 0 0 0 0 0 0 0 0 0 0 0 0 0 0 0 0 0 0 0
37 38 0 0 0 0 39 40 37 0 0 0 0 0 0 0 0 0 0 0 0 0 0 0 0 0 0 37 38 39 0 0 0 38 40 37 0 0 0
40 39 37 0 0 38 40 38 39 37 0 0 0 0 0 0 0 0 0 0 0 0 0 0 0 0 40 39 37 38 40 0 0 39 37 40 38 0 0
38 37 40 0 0 39 37 40 38 0 1 1 2 2 2 2 2 2 2 2 2 2 2 2 2 2 2 2 1 0 38 40 37 39 0 37 40 39 38 0
39 40 0 0 0 0 38 39 0 0 3 4 4 4 4 4 4 4 4 4 4 4 4 4 4 4 4 4 3 0 0 39 38 0 0 40 37 38 39 0
37 38 0 0 0 0 0 0 0 0 3 0 0 37 38 39 39 40 0 0 0 0 0 0 41 0 0 0 3 0 0 0 0 0 0 38 39 40 37 0
40 39 0 0 0 0 0 0 0 0 3 0 41 37 38 39 40 40 0 41 0 0 0 0 0 0 0 0 3 0 0 0 0 0 0 37 40 38 39 0
38 37 40 0 0 0 0 0 0 0 3 39 39 38 37 0 39 40 40 0 0 41 0 37 38 39 0 0 3 0 0 0 0 0 39 38 37 40 39 0
39 40 38 37 0 0 0 0 0 0 3 0 5 6 7 8 0 0 41 0 0 0 39 39 40 38 0 0 3 0 0 0 0 37 40 39 38 37 40 0
37 39 40 38 0 0 0 0 0 0 3 0 9 10 11 12 0 0 0 0 41 0 0 39 40 40 39 0 3 0 0 0 0 38 37 40 39 38 37 0
40 38 37 39 0 0 0 0 0 0 3 0 13 14 15 16 0 37 38 39 40 0 0 0 0 0 0 0 3 0 0 0 0 39 40 37 38 39 40 0
38 40 39 37 0 0 0 0 0 0 3 0 17 18 19 20 0 38 39 40 40 39 0 41 0 37 39 0 3 0 0 0 0 37 38 39 40 37 38 0
39 37 38 40 0 0 0 0 0 0 3 1 2 2 2 2 2 2 2 0 2 2 2 2 2 2 2 2 3 0 0 0 0 40 39 38 37 40 39 0
40 38 39 37 0 0 0 0 0 0 3 4 4 4 4 4 4 4 4 0 4 4 4 4 4 4 4 4 3 0 0 0 0 38 40 37 39 38 40 0
37 39 40 38 0 0 0 0 0 0 0 0 0 0 0 0 0 0 0 0 0 0 0 0 0 0 0 0 0 0 0 0 0 39 37 40 38 39 37 0
38 40 37 39 0 0 0 0 0 0 0 0 0 0 0 0 0 0 0 0 0 0 0 0 0 0 0 0 0 0 0 0 0 37 38 39 40 37 38 0
39 37 38 40 37 0 0 0 0 0 0 0 0 0 0 0 0 0 0 0 0 0 0 0 0 0 0 0 0 0 0 38 40 39 37 38 40 39 37 0
40 38 39 37 40 38 0 0 0 0 0 0 0 0 0 0 0 0 0 0 0 0 0 0 0 0 0 0 0 0 39 37 38 40 39 37 38 40 38 0
37 39 40 38 39 37 40 0 0 0 0 0 0 0 0 0 0 0 0 0 0 0 0 0 0 0 0 0 0 37 40 38 39 37 40 38 39 37 40 0
38 40 37 39 38 40 37 38 0 0 0 0 0 0 0 0 0 0 0 0 0 0 0 0 0 0 0 0 39 38 37 40 38 39 37 40 38 39 37 0
39 37 38 40 39 37 38 39 40 0 0 0 0 0 0 0 0 0 0 0 0 0 0 0 0 0 0 37 38 39 40 37 39 38 40 37 39 40 38 0
40 38 39 37 40 38 39 40 37 38 0 0 0 0 0 0 0 0 0 0 0 0 0 0 0 0 39 40 37 38 39 40 38 37 39 40 37 38 39 0
37 39 40 38 37 39 40 37 38 39 40 0 0 0 0 0 0 0 0 0 0 0 0 0 0 38 40 37 39 38 37 40 39 38 40 37 38 39 40 0
38 40 37 39 38 40 37 38 39 40 37 38 0 0 0 0 0 0 0 0 0 0 0 0 39 37 38 40 38 39 40 37 38 39 37 40 39 38 37 0